624050008
907204001
500897600
050421090
240709360
079530204
790005123
465302700
032970050