260790510
003062080
090051004
312546008
970013065
045800130
789120356
006080240
021005809