620087051
513624700
087013062
065098210
000000009
090132046
001356907
809040605
356870020