009230005
103504090
456097102
360908040
204003879
890042306
978300604
600780513
031020007