010809460
800540100
546010798
400351080
790462010
350008624
600024809
004987306
907605001