080406000
315009002
026310790
560031879
001897006
807060213
003142000
102900635
970603020