200000978
504907300
000320640
003790421
970410036
002060789
006000103
780105060
010046807