246000000
130000040
000406135
301097600
000200987
087064000
002900503
708050012
060142090