500002870
230098500
090405003
653200000
000879005
970300104
009024050
305900062
006010790