800040006
300970001
204050089
908300200
642000100
000006807
050097010
003500078
089001640