100090042
006053000
870004001
012709300
000006014
563020800
021008050
050300780
980640100