300900004
426010907
000024503
097405032
031008000
060002790
003241000
970350240
100809050