506807030
003504897
000030504
460009310
098000406
300026789
630900140
020650908
087100050