010008040
789600531
026530008
097050020
560023700
200000456
978000014
003204890
100097305