500798020
010003007
090402035
800030462
105040790
046870050
301650870
987301506
654087003